111111111111111111111111111111111111111111111111111111111111111111111111111111
1111111100000000PCE00000111111111111111111111111111111111111111111111111111111
111111110000000000000000011111111111111111111111111111111111111111111111111111
111111111C00C00000000000011111111111111111111111111111111111111111111111111111
11111111000000000C000000011111111111111111111111111111111111111111111111111111
111111110000000000000011111111111111111111111111111111111111111111111111111111
111111111111111111111111111111111111111111111111111111111111111111111111111111
111111111111111111111111111111111111111111111111111111111111111111111111111111
111111111111111111111111111111111111111111111111111111111111111111111111111111
111111111111111111111111111111111111111111111111111111111111111111111111111111
