11111111111111111111
10000000000000000001
1000000C00000000D001
11111111111111CC1111
100000000C0000000001
10000000P0000000E0C1
11111111111111111111
